Posicion,Pais,Oro,Plata,Bronce,Total
1,Estados Unidos,39,41,33,113
2,China,38,32,18,88
3,Japón,27,14,17,58
4,Reino Unido,22,21,22,65
5,Rusia,20,28,23,71
6,Australia,17,7,22,46
7,los Países Bajos,10,12,14,36
8,Francia,10,12,11,33
9,Alemania,10,11,16,37
10,Italia,10,10,20,40
